R  221 699
NO   ./tex.XPM   
SO ./wall_1.xpm



WE ./wall_2.xpm 
EA ./wall_1.xpm
S ./sprite_1.xpm


F 255,255,255
C 0,0,0

        1111111111111111111111111
        1000000000110000000000001
        1011000001110000000000001
        1001000000000000000000001
111111111011000001110000000000001
100000000011000001110000000001111
11110111111111011100000000001
11110111111111011101010000001
11000000110101011100000000001
1111111111111111111111111111
1111111111111111111111111111
10000000P0000020000000000001
1000002002020000000000000001
1100000101010201111101111000111
1111011111110101 101111010001
11111111 1111111 111111111111
